1111111111111
1000010100001
110P000001001
10000E0000011
10C0000010011
1000001000001
1111111111111