1111111111111
1000010100C01
110C0000C1001
10000E0000011
10C0000010P11
1000010100C01
1111111111111