1111111111111
1001P10001001
1000000E00011
100C001001011
1000101000001
1111111111111